NO ./path_to_the_north_texture
SO ./path_to_the_south_texture
WE ./path_to_the_west_texture
EA ./path_to_the_east_texture
F 220,100,0
C 225,30,0

1111111111111111111111111111111111111111111111
1111111111111111111111111111111111111111111111
1100000000000000000000000000000000000000000011
1100000000000000000000000000000000000000000011
110000000000000111111111100000000000000000011
110000000000000100000000100000000000000000011
110000000000000100000000100000000000000000011
110000000000000100000000100000000000000000011
1100000000000001000N0000100000000000000000011
110000000000000100000000100000000000000000011
110000000001000111111111100001000110000000011
110000000011000100000000100011000000000000011
1100000000110000010000000100110000000000100011
1100000001100000000000000001100000000000000011
1100000000000000000000000011000000000000000011
1100000000000000000001000010000000000000000011
1100110000000000000000000000000000000000000011
1111111111111111111111111111111111111111111111
1111111111111111111111111111111111111111111111
