NO img/north.xpm
SO img/cyan.xpm
WE img/west.xpm
EA img/wall.xpm

F 43,58,68
C 100,0,255

111111111111111111111111111111111111111111111111111111111
111111111111111111111111111110000000011111111111111111111
111111111111111111111111111100000000001111111111111111111
11111111111111111111111111100000000T000111100111111111111
111111111111111111111111110000000000000011100011111111111
11111111110001111111111111000T00000T000001100001111111111
111111111000011111111111110000000000000001100000111111111
111111110000000000000000000000000000000000000000111111111
111111110000011111100011110000000000000001100000111111111
1111111100000111110000011100T0000000000001110000111111111
111111110000011111000001110000000000000001111101111111111
111100111101111111000000110000000N00000011000101111111111
111000111101111110000000111000000000000110000101111111111
110000111101111111000000011100000000000000000000001100011
100000001101100011000000011110000000011100000111101100001
100000001101000001100000001111111011111111111111100000001
100000001101000001110000001111111000000000011111101100001
100000000000000001111111111111111011000000011110001100011
100000001101000001111111111111111011000000011110111111111
100000001101000001110000011111100001000000011110111111111
100000001101000000000000011111000001000000111110111111111
110000111101111111110000011110000001000001111100001111111
111000111101111111110000011100000001111111111000001111111
111100111101111111111110011100000001111111110000001111111
111111110000011111110000011100000000000000000000001111111
111111110000011111110000011100000001111101110000001111111
11111111000000000111000011110000000100l000010000011111111
111111110000011101110001111100000001000000010000111111111
111111111000011101110111111100000001000000010001111111111
111111111100011100000000000000000001000000011111111111111
111111111111111111111111111110000001100000111111111111111
111111111111111111111111111111000001111111111111111111111
111111111111111111111111111111100001111111111111111111111
111111111111111111111111111111111111111111111111111111111
