NO ./path_to_the_north_texture
SO ./path_to_the_south_texture
WE ./path_to_the_west_texture
EA ./path_to_the_east_texture
F 220,100,0
C 225,30,0

11111111111111111111111111111111111111111111
10000000000000000000000000000000000000000001
10000000000000000000000000000000000000000001
10000000000000111000111100000000000000000001
10000000000000100000000100000000000000000001
1000000000000010000000010000000000000000000111111111
1000000000000010000000010000000000000000000000000001
100000000000001000N000010000000000000000000111111111
10000000000000100000000100000000000000000001
10000000001000111111111100001000110000000001
10000000011000100000000100011000000000000001
10000000011000001000000010011000000000010001
10000000110000000000000000110000000000000001
10000000000000000000000001100000000000000001
10000000000000000000100001000000000000000001
10011000000000000000000000000000000000000001
11111111111111111111111111111111111111111111
