NO img/north.xpm
SO img/south.xpm
WE img/west.xpm
EA img/east.xpm
F 220,100,20
C 225,30,0

11111111111111111111111111111111111111111111
10000000000000000000000000000000000000000001
10010001000100000100010001000000000000000001
10010001000100100100010001000000000000000001
10010001000100100100010001000000000000000001
1000111000001101100000111000000000000000000111111111
1000000000000000000000000000000000000000000000000001
1000000000000000000000000000000000000000000111111111
10000000000000000000000000000000000000000001
10000000001000000000000000001000110000000001
10000000011000000000000000011000000000000001
10000000011000001000000010011000000000010001
100000001100000000000000001100000000A00E0001
10000000000000000000000001100000000000000001
10000000000000000000100001000000000000000001
10011000000000000000000000000000000000000001
11111111111111111111111111111111111111111111
