NO img/north.xpm
SO img/south.xpm
WE img/west.xpm
EA img/east.xpm
F 220,100,20
C 225,30,0

11111111111111111111111111111111111111111111111111111111111111111111111111111111111111111111111111111111
10000000000000000000000000000000000000000000000000000000000000000000000000000000000000000000000000000001
10010001000100000100010001000000000000100010001000001000100010000000000000000000000000000000000000000001
10010001000100100100010001000000000000100010001001001000100010000000000111111111111111111111111111111111
10010001000100100100010001000000000000100010001001001000100010000000000000000000000000000000000000000001
10001110000011011000001110000000000000011100000110110000011100000000000111111111111111111111111111111111
10000000000000000000000000000000000000000000000000000000000000000000000000000000000000000000000000000001
10000000000000000000000000000000000000000000000000000000000000000000000000000000000000000000000000000001
10000000000000000000000000000000000000000000000000010001000100000100010001000000000000000000010001000001
10000000001000000000000000001000110000000000000000010001000100100100010001000000000000000000010001000001
10000000011000000000000000011000000000000000000000010001000100100100010001000000000000000000010001000001
10000000011000001000000010011000000000010000000000001110000011011000001110000000000000000000010001000001
100000001100000000000000001100000000A0000000000000000100010001000001000100010000000000000000010001000001
10000000000000000000000001100000000000000000000000000100010001001001000100010000000000000000010001000001
10000000000000000000100001000000000000000000000000000100010001001001000100010000000000000000010001000001
10011000000000000000000000000000000000000000000000000011100000110110000011100000000000000000010001000001
10000000000000000000000000000000000000000000000000000000000000000000000000000000000000000000010001000001
10000000000000A00000000000000000000000000000000000000000000000000000000000000000000000000000010001000001
10000000000000000000000000000000000000000000000000000000000000000000000000000000000000000000010001000001
10000000000000000000000000000000000000000000000000000000000000000000000000000000000000000000010001000001
10000000000000000000000000000000000000000000000000000000000000000000000000000000000000000000010001000001
10000000000000000000000000000000000000000000000000000000000000000000000000000000000000000000010001000001
10000000000000000000000000000000000000000000000000000000000000000000000000000000000000000000010001000001
10000000000000000000000000000000000000000000000000000000000000000000000000000000000000000000010001000001
10000000000000000000000000000000000000000000000000000000000000000000000000000000000000000000010001000001
10000000000000000000000000000000000000000000000000000000000000000000000000000000000000000000010001000001
10000000000000000000000000000000000000000000000000000000000000000000000000000000000000000000010001000001
10000000000000000000000000000000000000000000000000000000000000000000000000000000000000000000010001000001
10000000000000000000000000000000000000000000000000000000000000000000000000000000000000000000010001000001
10000000000000000000000000000000000000000000000000000000000000000000000000000000000000000000000000000001
10000000000000000000000000000000000000000000000000000000000000000000000000000000000000000000000000000001
10000000000000000000000000000000000000000000000000000000000000000000000000000000000000000000000000000001
10000000000000000000000000000000000000000000000000000000000000A00000000000000000000000000000000000000001
10000000000000000000000000000000000000000000000000000000000000000000000000000000000000000000000000000001
10000000000000000000000000000000A00000000000000000000000000000000000000000000000000000000000000000000001
10000000000000000000000000000000000000000000000000000000000000000000000000000000000000000000000000000001
10000000000000000000000000000000000000000000000000000000000000000000000000000000000000000000000000000001
100000000000000000000000000000000000000000000000000000000000000A0000000000000000000000000000000000000001
1000000000A000000000000000000000000000000000000000000000000000000000000000000000000000000000000000000001
10000000000000000000000000000000000000000000000000000000000000000000000000000000000000000000000000000001
1000000000000000000000000A000000000000000000000000000000000000000000000000000000000000000000000000000001
10000000000000000000000000000000000000000000000000000000000000000000000000000000000000000000000000000001
100000000000000000000000000000000000000000A0000000000000000000000000000000000000000000000000000000000001
10000000000000000000000000000000000000000000000000000000000000000000000000000000000000000000000000000001
10000000000000000000000000000000000000000000000000000000000000000000000000000000000000000000000000000001
10000000000000000000000000000000000000000000000000000000000000000000000000000000000000000000000000000001
1000000000000000000000000000A000000000000000000000000000000000000000000000000000000000000000000000000001
10000000000000000000000000000000000000000000000000000000000000000000000000000000000000000000000000000001
10000000000000000000000000000000000000000000000000000000000000000000000000000000000000000000000000000001
10000000000000000000000000000000000000000000000000000000000000000000000000000000000000000000000000000001
1000000000000A000000000000000000000000000000000000000000000000000000000000000000000000000000000000000001
10000000000000000000000000000000000000000000000000000001111000000000000000000000000000000000000000000001
10000000000000000000000000000000000000000000000000000001  1000000000000000000000000000000000000000000001
10000000000000000000000000000000000000000000000000000001111000000000000000000000000000000000000000000001
10000000000000000000000000000000000000000000000000000000000000000000000000000000000000000000000000000001
10000000000000000000000000000000000000000000000000000000000000000000000000000000000000000000000000000001
10000000000000000000000000000000000000000000000000000000000000000000000000000000000000000000000000000001
10000000000000000000000000000000000000000000000000000000000000000000000000000000000000000000000000000001
10000000000000000000000000000000000000000000000000000000000000000000000000000000000000000000000000000001
10000000000000000000000000000000000000000000000000000000000000000000000000000000000000000000000000000001
10000000000000000000000000000000000000000000000000000000000000000000000000000000000000000000000000000001
1000000000000000000000000000000000000000000A000000000000000000000000000000000000000000000000000000000001
10000000000000000000000000000000000000000000000000000000000000000000000000000000000000000000000000000001
10000000000000000000000000000000000000000000000000000000000000000000000000000000000000000000000000000001
10000000000000000000000000000000000000000000000000000000000000000000000000000000000000000000000000000001
10000000000000000000000000000000000000000000000000000000000000000000000000000000000000000000000000000001
100000A0000000000000000000000000000000000000000000000000000000000000000000000000000000000000000000000001
10000000000000000000000000000000000000000000000000000000000000000000000000000000000000000000000000000001
100000000000000000A0000000000000000000000000000000000000000000000000000000000000000000000000000000000001
100000000000000000000000000000000000000000000000000000000000000000000000000000000000000000000000000000N1
11111111111111111111111111111111111111111111111111111111111111111111111111111111111111111111111111111111
