NO img/astronaut.xpm
SO img/e.xpm
WE img/ironman.xpm
EA img/ori.xpm
F 43,58,68
C 100,0,255

11111111111111111111111111111111
10000000000011111111111000000001
10000000011111111111111111000001
10000000011100000001111111100001
10000000111000111101111111110001
10000000111001111100000001111101
10011111110001111100000000001101
10111111110001111111111111111101
10111001110000111111111111111101
10111001110000011111111111111001
1011110000000N000000000000111001
10011111110000011111111101110001
10000000110000011101111001110001
10000000110000011101110001110001
10000000111111111101111111100001
10000000111111111000000000000001
11111111111111111111111111111111
