NO img/astronaut.xpm
SO img/e.xpm
WE img/ironman.xpm
EA img/ori.xpm

F 43,58,68
C 43,58,68

111111111111111111111111111111111
100000000000000000000000000000001
10000000011111Z111111111110000001
100000000111000000011111111000001
100000001110001111Z11111111100001
100000001110011111000000011111001
100111Z1110001111100N000000011001
101111Z11100011111111111Z11111001
101110011100001111111111Z11111001
101111Z11100000111111111Z11110001
101111000000000000000000001110001
100111111100000111111111Z11100001
100000001100000111011110011100001
100000001100000111011100011100001
100000001111Z11111011111Z11000001
100000001111Z11110000000000000001
100000000000000000000000000000001
111111111111111111111111111111111
