NO img/north.xpm
SO img/east.xpm
WE img/west.xpm
EA img/wall.xpm

F 43,58,68
C 100,0,255

T0 img/cyan.xpm

Z0 img/door/door1.xpm
B1 img/door/door2.xpm
V2 img/door/door3.xpm
C3 img/door/door4.xpm

111111111111111111111111111111111111111111111111111111111
111111111111111111111111111110000000011111111111111111111
111111111111111111111111111100000000001111111111111111111
11111111111111111111111111100000000T000111100111111111111
111111111111111111111111110000000000000011100011111111111
11111111110001111111111111000T00000T000001100001111111111
111111111000011111111111110000000000000001100000111111111
111111110000000000000000000000000000000000000000111111111
11111111000001111111Z111110000000000000001100000111111111
1111111100000111110000011100T0000000000001110000111111111
111111110000011111000001110000000000000001111101111111111
1111001111Z1111111000000110000000N00000011000101111111111
1110001111011111100000001110000000000001100001Z1111111111
110000111101111111000000011100000000000000000000001100011
100000001101100011000000011110000000011100000111101100001
100000001101000001100000001111111Z11111111111111100000001
1000000011Z1000001110000001111111000000000011111101100001
100000000000000001111111111111111011000000011110001100011
1000000011Z1000001111111111111111Z11000000011110111111111
10000000110100000111000001111110000100000001111Z111111111
100000001101000000000000011111000001000000111110111111111
110000111101111111110000011110000001000001111100001111111
111000111101111111110000011100000001111111111000001111111
1111001111Z1111111111111111100000001111111110000001111111
111111110000011111110000011100000000000000000000001111111
1111111100000111111100000111000000011111Z1110000001111111
11111111000000000111000011110000000100T000010000011111111
111111110000011101110001111100000001000000010000111111111
11111111100001110111Z111111100000001000000010001111111111
111111111100011100000000000000000001000000011111111111111
111111111111111111111111111110000001100000111111111111111
111111111111111111111111111111000001111111111111111111111
111111111111111111111111111111100001111111111111111111111
111111111111111111111111111111111111111111111111111111111